                                                                                
           ~~~~~~~~                                                             
                                                                                
                                                                                
                                                                                
                                                                                
                   ~~~~~~~                      /\ /\                 /\ /\ /\  
                                                                                
                                                                                
      ++++++++++++++++++++X                                                     
      +                                             /\ /\ /\                    
      +                         ~~~~~~~                                         
      +                                                                         
      +                                                                         
      +                                                                         
      +                 +++++++++++++++++++++++++++++                           
      +                 +                           +                           
      +                 +                           +                           
      +                 +                           +                           
      +       ~~~~~~~~  +                           +                           
      +++++++++++       +                           +                           
                +/\     +                           +                           
                +       +      /\                   +   /\                      
                +       +                           +                           
                +       +                           +                           
                +       +                           +                           
                +       +                           +                           
                +       +                           +                           
                +       +                           +                           
                +       +                           +                           
                +       +                                                       
                +       +                         ~~~~   /\ /\ /\               
                +       +                                                       
                +       +                                                       
                +++++++++                                          ~~~~~~       
                                                                                
                                                                                
                                                                                
                       ~~~~                                                     
                                                                                